########
#    ..#
# $ ## #
# #$$ .#
# $@  ##
#  #  .#
########