##########
#        #
#  ....  #
#  $$$$  #
#        #
#    @   #
#        #
##########