##########
#      ###
#  #     #
#  #  #$ #
##$##$# ##
#.       #
#.. #   @#
##########