##########
#      ..#
#    #$.##
# $ $#  .#
#@$ $   .#
# $ $#$.##
#    # ..#
##########