##########
#   # .  #
# #  $$# #
# ##@. # #
#  ###   #
# $ $ $ ##
# .#. .  #
##########